#####################
#P.....#.......#....#
###.#.###.#####.###.#
#.....#.......#.....#
#.###.#######.#.###.#
#.#..........Y#.#...#
#.#.###.#.#####.###.#
#.#.#...#.....K.....#
#.#.#.###.###.###.###
#...#.#.........#...#
#####.#.###.###.#.#.#
#.....#.....#...#.#.#
###########.#####.#.#
#D..............#..X#
#####################
